technische|technisch|yes
Favoritenstrasse|Fav.strasse|yes
Josefgasse|Josephgasse|yes
thisshouldbeone|thisshouldbeone|yes
thisshouldntbeone|thisshouldbeone|no
howmanymoreinputs|howmanyinputs|no
ErzherzogKarl|erzherzogkarl|yes
abcdefgh|xyzabc|no
similarity|simultaneous|no
transparent|transverse|no
Stephansdom|Steffl|no
galaxyS4|HTCOne|no
galaxyOne|HTCOne|no
homogeneous|heterogenous|no
identical|different|no
oneandthesame|HTCOne|no
interchangeable|change|no
matching|unmatched|no
exact|opposite|no
exact|intact|no
collateral|principal|no
major|minor|no
similar|dissimilar|no
independent|dependent|no
Michael|Mike|yes
Michael|Mickael|yes
Michel|Michael|yes
starvation|salvation|no
supersized|downsized|no
blasphemy|alchemy|no